$ANSIBLE_VAULT;1.1;AES256
31313237353232616266353364633039646530343862356633656236373863343836306662353934
6661343063316630643537356535623430363764643462320a363530323937363138633731396366
36353630363131643363643338386263333730623831393461366462626332633965326266303666
3865613965333962380a396464376138333536353632303936386432386263333461333365313362
64336265653536393166633038313739613964343438313538386336343630316630663232326530
3935623636613962386539363134623131616233363362396130
