$ANSIBLE_VAULT;1.1;AES256
31663632626531376430626236356134396538633562363935373038653432383632653134336565
3166373038363038343263303533383439656664616238660a313437646465383037653564383032
35646632353436386438326136346332306333636564333430346134636231306632616238626266
6631396637613033320a386661313066303465656662363463303631396565323062633334396364
32323431343662376234346165356264393563646361336135643332626239313466653464346439
3136663864386339626234323765616633653562643737323335
