$ANSIBLE_VAULT;1.1;AES256
31303737396462376537363664393839303764343661356236636632323937663562626662383838
6463623564366636626437663637326437346464303530630a636563336537636239636361303535
30653062353635393162323064336662383031306133343361376639643432303362386431373166
6635643530316534390a653135393230643664353934343738363135313166633264356533393335
62646333323230353266633638373661663561303132333364373961376563646236363231656166
38353864323833343135303139623065323066656438373663613361653430663337333934316236
63336439303936363361623766386363653661633562353431623735313936366563666263323661
30393966636235343339
